#######
#     #
#  .. #
#  oo #
# p   #
#     #
#######
