#######
#     #
#  .o #
#  o. #
# p   #
#     #
#######
