#######
#  .o #
#  o  #
#  .  #
# p   #
#     #
#######
