#######
#     #
#  .. #
#     #
# poo #
#     #
#######
