#######
#.   .#
#     #
#     #
# poo #
#     #
#######
